11111111111
1C00000C0C1
101001C1001
1111C0100E1
1C10000C0P1
11111111111
